F 100,100,100
C 0,0,1

NO  pics/NO.xpm
SO  pics/SO.xpm
EA  pics/EA.xpm
WE  pics/WE.xpm



                       1
                      101
                     10001
                    1000001
                   100000001
                  10000000001
                 1000000000001
                100000000000001
               10000000N00000001
              1000000000000000001
             100000000000000000001
            10000000000000000000001
            11111111111111111111111
