C 0,0,0
F 69,69,69

NO	pics/bush.xpm
SO	pics/bush.xpm
EA	pics/bush.xpm
WE	pics/bush.xpm
DO	pics/door_open.xpm
S 	pics/pokeball.xpm
EN	pics/togepi.xpm
DC  pics/door_close.xpm

11111111111111111111111111111111111111111
111111111111040404040400400000000000000011
111111111114000000000000000000020000000001111111111111111111111111111111111111111
114411111140000000000020000000000000200000000030000000000000000000000000000000001
114411111400000000040000000000000000000000011111111111111113111111111111111111101
11440111140004000000000000000010000020000000111           1401                101
11140010400000400000200000000100000000000000001           1041                101
11440000004000000040000000401000400004004000001           1401                101
11440001004000400000004000010000000000004004001           1041                101
114400004000000040400000001000400000040000000011          1401                101
111400104000040000000011111111111100000004000001111111111100011111111111111111131111111111
1144011100400002000000140000000041040000000000000004000000000000400000000000110000011
11441111100002000000010000004000401000000000000000000200000000000000000000000100E0021111
11441111110000000000100000000000000100400000000000000002000000000000000000000300002001
111111111110000000000000000400000040000000000011111111111311111111111111111111111111111111111
111111111111000000000000000000000000400040000112222222222222222221444011
111111111111040404040404000000000400004004000012222222222222222221444111
111111111111111111111111111111111111111111111112222222222222222221444111
111111111111111111111111111111111111111111111111111111111111111111111111
















