R 800 800
C 0,0,0
F 69,69,69

NO	pics/bush.xpm
SO	pics/bush.xpm
EA	pics/bush.xpm
WE	pics/bush.xpm
DO	pics/door_open.xpm
S 	pics/pokeball.xpm
EN	pics/togepi.xpm
DC  pics/door_close.xpm

1111111111111111111111111111111111111111111111111111111111111
1444444400000000000000000000000000000000000000000000000000001
1400000000000000000000000000000000000000000000000000000000041
1400000000000000000000000000000000000000000000000000000000041
1400000000000000000000000000000000000000000000000000000000041
1400000000000000000000000000000000000000000000400000000000041
1400000000000000000000000000000000000000000000000000000000041
1400000000000000000000000000000000000000000000000000000000041
1400000000000000000000000000000000000000000000000000000000041
1400000000000000000000000000000000000000000000000000000000041
1400000000000000000000000000000000000000000000000000000000041
140000000000000000000000000000000000000000000000000000001111111111111111
140000000000000000400000000000000000000400000000000000000000100002000001
140000000000000000000000000000000000000000000000000000000000300000000N01
140000000000000000000000000000000000000004000000000000000000100000020001
140000000000000000000000000000000000000000000000000000001111111111111111
1400000000000000000000000000000000000000000000000000000000041
1400000000000000000400000000000000000000000000000000000000041
1400000000000000000000000000000000000000000000000000000000041
1400000000000000000000000000000000000000000000000000000000041
1400000000000000000000000000400000000000000000000000000000041
1400000000000000000000000000000000000000000000000000000000041
1400000000000000000000000000000000000000000000000000000000041
1400000000000000000000000000000000000000000000000000000000041
1400000000000000000000000000000000000000000000000000000000041
144444440000000000000000000000000000000000000000000000000001
1111111111111111111111111111111111111111111111111111111111111
