F 100,100,100
C 0,0,1

NO  pics/NO.xpm
SO  pics/SO.xpm
EA  pics/EA.xpm
WE  pics/WE.xpm


                        1111111111111111111111111111111111111111111111111111111111111
                        1000000000000000000000000000000000000000000000000000000000001
                        1000000000000000000000000000000000000000000000000000000000001
                        1000000000000000000000000000000000000000000000000000000000001
                        1000000000000000000000000000000000000000000000000000000000001
                        1000000000000000000000000000000000000000000000000000000000001
                        1000000000000000000000000000000000000000000000000000000000001
                        1000000000000000000000000000000000000000000000000000000000001
                        1000000000000000000000000000000000000000000000000000000000001
                        1000000000000000000000000000000000000000000000000000000000001
                        1000000000000000000000000000000000000000000000000000000000001
                        1000000000000000000000000000000000000000000000000000000000001
                        1000000000000000000000000000000000000000000000000000000000001
                        1000000000000000000000000000000000000000000000000000000000001
                        1000000000000000000000000000000000000000000000000000000000001
                        1000000000000000000000000000000000000000000000000000000000001
                        1000000000000000000000000000000000000000000000000000000000001
1111111110111111111111111000000000000000000000000000000000000000000000000000000000001
1N00000000000000000000000000000000000000000000000000000000000000000000000000000000001
1111111111111111111111111000000000000000000000000000000000000000000000000000000000001
                        1000000000000000000000000000000000000000000000000000000000001
                        1000000000000000000000000000000000000000000000000000000000001
                        1000000000000000000000000000000000000000000000000000000000001
                        1000000000000000000000000000000000000000000000000000000000001
                        1000000000000000000000000000000000000000000000000000000000001
                        1000000000000000000000000000000000000000000000000000000000001
                        1111111111111111111111111111111111111111111111111111111111111
