R 1920
F 100,100,100
C 0,0,1

NO  pics/NO.xpm
SO  pics/SO.xpm
EA  pics/EA.xpm
WE  pics/WE.xpm
S   pics/small_shrek.xpm

        1111111111111111111111111
        1000000000110000000000001
        1011000001110000002000000
        1001000000000000000000001
111111111011000001110000000000001
100000000011000001110111111111111
11110111111111011100000010001
11110111111111011101010010001
11000000110101011100000010001
10002000000000001100000010001
10000000000000001101010010000
11000001110101011111011110N0111
11110111 1110101 101111010001
11111111 1111111 111111111111
